; Default CSSE2002 Pacman Map
; board Keys
; getWidth, getHeight
;   - X Wall
;   - 0 No Item, 1 dots
;   - B Big dots spawn ( occupied ), b big dot spawn ( not occupied )
;   - $ Ghost spawn zone
;   - P pacman spawn zone
[Board]
23,24
XXXXXXXXXXXXXXXXXXXXXXX
X1111111111X1111111111X
X1XX1XXXX11X11XXXX1XX1X
X1XX1XX111111111XX1XX1X
X111B111111X111111B111X
X1XXXXXXX11X11XXXXXXX1X
X111X1111111111111X111X
X1111111111P1111111111X
X11XXXXXXXXXXXXXXXXX11X
X111111111111111111111X
X1111X1XXX111XXX1X1111X
XXXXXX1XXX1$1XXX1XXXXXX
X1111X1XXX111XXX1X1111X
X111111111111111111111X
X11XXX11111111111XXX11X
X11XXXXXXX1X1XXXXXXX11X
X111X111111X111111X111X
X111X11XXXXXXXXX11X111X
X111X111111X111111X111X
X111B111111X111111B111X
X1XX1XX1111X1111XX1XX1X
X1XX1XXXX11X11XXXX1XX1X
X1111111111X1111111111X
XXXXXXXXXXXXXXXXXXXXXXX

[Game]
title = Test 2 - BIG
author = Teanlouise
lives = 5
level = 0
score = 123
hunter = 1,1,LEFT,0,SPEEDY
blinky = 3,6,UP,FRIGHTENED:15
inky = 1,6,UP,SCATTER:7
pinky = 8,6,UP,FRIGHTENED:15
clyde = 6,4,UP,CHASE:4

; Must have one blank line between each block.
; Comments do not count as a line
[Scores]
Evan : 112456
Peter : 100